12
10
150
0 0 0 0 0 0 0 0 0 0 0 0 0 0 0 0 0 0 0 0 0 0 0 0 0 0 0 0 0 0 0 0 0 0 0 0 0 0 0 0
2 2 2 2 2 2 2 2 2 2 2 2 2 2 2 2 2 2 2 2 2 2 2 2 2 2 2 2 2 2 2 2 2 2 2 2 2 2 2 2
2 3 3 3 3 3 3 0 3 3 4 3 1 0 3 3 3 3 3 1 3 1 3 3 3 3 3 3 3 0 3 3 3 3 1 3 3 3 3 2
2 3 1 5 1 3 3 3 3 3 3 0 3 3 3 3 3 3 3 3 3 1 4 3 3 1 3 3 3 3 0 3 3 3 3 3 0 3 3 2
2 3 3 3 3 3 3 3 3 3 3 0 3 3 0 3 3 3 3 3 1 3 1 3 3 1 3 3 3 3 3 3 3 3 1 3 3 3 3 2
2 1 3 0 0 3 3 3 3 3 3 3 3 3 1 3 3 3 3 3 3 1 3 3 1 3 3 3 3 1 3 3 3 1 3 3 3 3 3 2
2 1 3 1 1 3 3 3 3 3 3 3 3 3 1 1 3 3 1 3 3 3 3 3 3 3 3 1 3 3 3 3 3 3 1 3 1 0 3 2
2 3 3 3 1 3 3 1 3 3 3 3 3 3 3 3 1 3 3 3 3 3 1 3 0 1 3 3 3 3 3 3 3 3 1 3 1 1 3 2
2 2 2 2 2 2 2 2 2 2 2 2 2 2 2 2 2 2 2 2 2 2 2 2 2 2 2 2 2 2 2 3 3 3 1 3 3 1 3 2
2 3 0 3 3 3 1 3 3 4 3 0 3 3 1 3 1 3 3 3 3 3 3 3 3 3 3 4 3 1 3 3 3 3 3 3 3 1 3 2
2 3 3 4 3 3 3 3 3 1 3 3 3 3 3 0 3 3 3 3 3 3 3 3 1 0 0 1 3 3 4 3 3 3 3 1 3 3 3 2
2 3 3 3 1 3 3 1 3 1 3 3 3 3 3 3 3 3 3 3 3 3 3 3 1 1 3 1 3 3 1 3 3 3 3 3 3 3 3 2
2 3 0 3 3 3 3 3 1 3 3 3 3 3 3 3 3 1 1 0 3 3 3 3 3 3 3 1 3 3 1 3 4 3 3 3 3 0 3 2
2 3 1 3 3 0 3 3 1 3 0 0 3 3 3 3 3 1 3 1 4 3 3 4 3 3 3 3 1 3 3 3 1 3 3 4 3 1 3 2
2 3 4 1 3 3 3 3 3 3 3 3 3 3 3 3 3 3 1 1 1 3 3 1 3 3 3 3 3 3 3 3 4 3 3 3 3 3 1 2
2 3 3 3 3 3 3 3 3 2 2 2 2 2 2 2 2 2 2 2 2 2 2 2 2 2 2 2 2 2 2 2 2 2 2 2 2 2 2 2
2 0 0 3 3 3 3 3 3 3 3 3 0 3 3 3 4 3 3 3 3 1 3 3 3 3 3 1 3 3 3 1 3 3 3 3 3 3 3 2
2 1 0 3 3 3 3 3 3 3 3 3 1 1 3 3 1 3 3 3 3 3 3 3 3 1 3 3 3 3 3 3 1 3 1 0 3 3 3 2
2 3 1 3 3 1 3 3 3 3 3 3 3 3 1 3 3 3 3 3 1 3 0 0 3 3 3 3 4 3 3 3 1 3 1 1 3 3 3 2
2 3 3 3 3 1 4 3 3 0 3 3 3 3 3 3 3 3 1 3 3 3 3 3 3 1 3 1 4 3 3 3 3 3 3 1 3 3 3 2
2 3 3 3 0 3 3 0 3 1 3 3 1 3 1 1 3 3 3 3 3 3 3 3 3 1 3 1 4 3 3 3 3 3 3 1 3 3 1 2
2 3 4 3 3 3 3 1 3 3 3 3 3 0 3 3 3 3 3 3 3 3 3 0 3 1 3 3 1 3 3 3 3 1 3 3 3 1 3 2
2 2 2 2 2 2 2 2 2 2 2 2 2 2 2 2 2 2 2 2 2 2 2 2 2 2 2 2 2 2 2 2 2 2 2 2 2 2 2 2